111111111111111111111111111111
100000000000000000000000000001
100000000000000000000000000001
100000000000000000000000000001
100000000000000000000000000001
100000000000000000000000000001
100000000000000000000000000001
100000000000000000000000000001
100000000000000000000000000001
100000000000000000000000000001
100000000000000000000000000001
100000000000000000000000000001
100000000000000000000000000001
100000000400000000040000000001
100000000000000000000000000001
100000000400000000040000000001
100000000000000000000000000001
100000000400000000040000000001
100000000000000000000000000001
100000000400000000040000000001
100000000000000000000000000001
100000000000003000000000000001
100000000000000000000000000001
100040000000000000000004000001
100000000000000000000000000001
100000400000000000000400000001
100000000400400400400000000001
100000000000000000000000000001
100000000000000000000000000001
100000000000000000000000000001
100000000000000000000000000001
100000000000000000000000000001
100000000000000000000000000001
100000000000000000000000000001
100000000000000000000000000001
100000000000000000000000000001
100000000000000000000000000001
100000000000000000000000000001
100000000000000000000000000001
100000000000000000000000000001
100000000000000000000000000001
100000000000000000000000000001
100000000000000000000000000001
100000000000000000000000000001
100000000000000000000000000001
100000000000000000000000000001
100000000000005000000000000001
100000000000000000000000000001
111111111111111111111111111111