111111111111111111111111111111
100000400000000000000000030001
100000000000000000000000000001
100000000000000000000000000001
100000000000000000000000000001
104000000111111111111111111111
100000000000000000000000000401
100000000000000000000000000001
100000000000000000000000000001
100000000000000000000000000001
111111111111111111111100000001
100000000000000000000000000001
100000000000000000000000000001
100000000000000000000000000001
140000000000000000000000000001
100000001111111111111111111111
100000000000000000000000000001
100000000000000000000000000001
100000000000000000000000000001
100000000000000000000000000001
111111111111111110000000000001
100000000040000000000000400001
100000000000000000000000000001
100000000000000000000000000001
100000000000000000000000000001
100000000000000000040000000001
100000000000000000000000000001
100000000000000000000000000001
100000000000000000000000000001
100000000040000000000000000001
100000000000000000000000000001
100000111111111111111111111111
100000000000000000000000000001
100000000000000000000000000001
100000000000000000000000000001
100000000000000000000000000001
100000000000000000000000000001
111111111111111111111110000001
100000000000000000000000000001
104000000000000000000000000001
100000000000000000000000000001
100000000000000000000000000001
100000000000000000000000000001
100000011111111111111111111111
100000000000000000000000000001
100000000000000000000000005001
100000000000000000000000000001
100000000000000000000000000001
111111111111111111111111111111