111111111111111111111111111111
100000000140040040000000000001
100500000100000000000000000001
100000000100000000000000040001
100000000100000000000000000001
111100000100000000000000000001
100000000100000001111110000001
100000000100000001000010000001
100000000000000001000010000001
100000000000000001000010000001
100000000000000001000010000001
100000000000000001000010000001
100000000000000001000014000001
100000000000000001000010000001
111111111111111111000010000001
140000000000000000000010000001
100000000000000000000010000001
140000000000000000000010000401
100000000000000000000010000001
140000000000000000000010000001
100000000000000000000010000001
100000000000000000000000000001
100000001111111000000000000001
100000000004001000000000000001
140000000000001000000000000001
100000000000001000000000000001
111111110000001111111111111111
100030010000000000000000004001
100000010000000000000000000001
100000010000000000000000000001
140000010000000004000100000001
100000010000000000000100000001
100000010000000000000100000001
100000011111111111111100000001
140000000000000000000100000001
100000000000000000000100000001
100000000000000000000100000001
100000000004000000000100000001
140000000000000000000100000001
100000000000000000000000000001
100000000000000000000000000001
140000011111111110000000000001
100000000000000000000000000001
100000000000000000000000000001
140000000000000000000000000001
100000000000000000000000000001
104004004000000000000000000001
100000000010000000000000000001
111111111111111111111111111111