111111111111111111111111111111
100000000000000000000000000001
105000000000000000000000000001
100000000000000000000000000001
100000000000000000000000000001
100000000000000000000000000001
100000000000000000000000000001
100000000000000000000000000001
100000000000000000000000000001
100000000000000000000000000001
100000000000000000000000000001
100000000000000000000000000001
100000000000000000000000000001
100000000000000000000000000001
100000000404040404040000000001
100000000000000000000000000001
100000040000000000000400000001
100000000000000000000000000001
100004000000000000000004000001
100000000000040400000000000001
100004000004000004000004000001
100000000000000000000000000001
100004000040005000400004000001
100000000000000000000000000001
100004000000000004000004000001
100000000000000000000000000001
100000040000000000000400000001
100000000000000000000000000001
100000000000000404040000000001
100000000000000000000000000001
100000000000000000000000000001
100000000000000000000000000001
100000000000000000000000000001
100000000000000000000000000001
100000000000000000000000000001
100000000000000000000000000001
100000000000000000000000000001
100000000000000000000000000001
100000000000000000000000000001
100000000000000000000000000001
100000000000000000000000000001
100000000000000000000000000001
100000000000000000000000000001
100000000000000000000000000001
100000000000000000000000000001
100000000000000000000000000001
130000000000000000000000000301
100000000000000000000000000001
111111111111111111111111111111