111111111111111111111111111111
100000001000000000100000000001
105000000000000000000000000001
100000001000000000100000000001
100000000000010000000001000001
100000001000000000100000000001
100000000000010000000001000001
100000001000000000100000000001
100000000000010000000001000001
100000001000000000100000000001
100000000000010000000001000001
100000001000000000100000000001
100000000000010000000001000001
100000001000000000100000000001
100000000000010000000001000001
100000001000000000100000000001
100000000000010000000001000001
100000001000000000100000000001
100000000000010000000001000001
100000001000000000100000000001
100000000000010000000001000001
100000001000000000100000000001
100000000000010000000001000001
100000000000000000000000000001
100000000000010000000001000001
111111111111111111111111000001
100000000000000000000000000001
100000000000000000000000000001
100000000000000000000000000001
100000011111111111111111111111
100000010000000001000000000001
100000000000000000000000000001
100000010000000001000000000001
100000000000100000000010000001
100000010000000001000000000001
100000000000100000000010000001
100000010000000001000000000001
100000000000100000000010000001
100000010000000001000000000001
100000000000100000000010000001
100000010000000001000000000001
100000000000100000000010000001
100000010000000001000000000001
100000000000100000000010000001
100000010000000001000000000001
100000000000100000000010000001
100000000000000000000000000301
100000000000100000000010000001
111111111111111111111111111111