111111111111111111111111111111
100000000000000000000000000001
105000000000000000000000040001
100000000000000000000000000001
100000000000000000000000000001
111111000001111111000111111111
100000000000000000000000000001
100000000000000000000000000001
100000000000000000000000000001
140000000000000000000000000001
100000000000000000000000000001
111110011111111111111110000001
100000000000000000000000000001
100000000000000000000000000001
104000000000000000000000000001
100000000000000000000000004001
100000000000000000000000000001
100000011111111100111110011111
100000000000000000000000000001
100000000000000000000000000001
100000000000000000000000000001
104000000000000000000000000001
100000001111111111111000001111
100000000000000000000000000001
100000000000000000000000000001
100000000000000000000000000001
100000000000000000000000000001
111111111111100000011111111111
140000000000000000000000000001
100000000000000000000000000001
100000000000000000000000000001
100000011111111111111111111111
100000000000000000000000000001
100000000000000000000000000001
100000000000000000000000000001
100000000000000000000000000001
110000001111111100000011111111
100000000000000000000000000001
100000000000000000000000000001
100000000000000000000000000001
100000000000000000000000000001
111111111111111111111110000001
140000000000000000000000000001
100000000000000040000000000001
100000000000000000000000000001
100000000000000000000000000001
103000000000000000000000004001
100000000000000000000000000001
111111111111111111111111111111