111111111111111111111111111111
100000000000001100000000000001
105000000000001100000000000301
100000000000001100000000000001
100000000000001100000000000001
100000000000001100000000000001
100000000000001100000000000001
100000000000001100000000000001
100000000000001100000000000001
100000000000001100000000000001
100000000000001100000000000001
100000000000001100000000000001
100000000000001100000000000001
100000000000001100000000000001
100000000000001100000000000001
100000000000001100000000000001
100000000000001100000000000001
100000000000001100000000000001
100000000000001100000000000001
100000000000000000000000000001
100000000000000000000000000001
100000000000000000000000000001
111111111110000000011111111111
111111111110000000011111111111
100000000000000000000000000001
100000000000000000000000000001
100000000000000000000000000001
100000000000001100000000000001
100000000000001100000000000001
100000000000001100000000000001
100000000000001100000000000001
100000000000001100000000000001
100000000000001100000000000001
100000000000001100000000000001
100000000000001100000000000001
100000000000001100000000000001
100000000000001100000000000001
100000000000001100000000000001
100000000000001100000000000001
100000000000001100000000000001
100000000000001100000000000001
100000000000001100000000000001
100000000000001100000000000001
100000000000001100000000000001
100000000000001100000000000001
100000000000001100000000000001
103000000000001100000000000301
100000000000001100000000000001
111111111111111111111111111111