111111111111111111111111111111
100000000000050000000000000001
100000000000000000000000000001
100000000000000000000000000001
100400040000000000004000040001
100000000000000000000000000001
100000000000040000000000000001
100000000000000000000000000001
100000000000000000000000000001
100000000000000000000000000001
104000000000000000000000004001
100000040000000000000400000001
100000000000000000000000000001
100000000000000000000000000001
100000000000000000000000000001
140000000000040000000000000401
100000000000000000000000000001
100000000000000000000000000001
100000000000000000000000000001
100000000000000000000000000001
100011110000000000111100000001
100000000000000000000000000001
100000000000000000000000000001
100000000000000000000000000001
100000000000040000000000000001
100000000000000000000000000001
100000000000000000000000000001
100040000000000000000000400001
100000000000000000000000000001
100000000000000000000000000001
100000000000000000000000000001
100000000000000000000000000001
100000000000000000000000000001
100000011111111111111110000001
100000000000000000000000000001
100000000000000000000000000001
100000000000000000000000000001
100000000000000000000000000001
100000000000000000000000000001
140000000000000000000000004001
100000000000000000000000000001
100000000000000000000000000001
100000000000000000000000000001
140000000000000000000000004001
100000000000000000000000000001
100000000000000000000000000001
104003004003004003004003004001
100000000000000000000000000001
111111111111111111111111111111