111111111111111111111111111111
100000000000000000000000000001
103000000000000000000004000001
100000000000000000000000000001
100000000000000000000000000001
100000000000000000000000000001
100000000000000400000000000001
100000000000000000000000000001
100000000000000000000000000001
100000000000000000000000000001
100000000000000400000000000001
100000000000000000000000000001
100000000000000000000000000001
100000000000000000000000040001
100400404004000000000000000001
100000000000000000000000000001
100000000000040400400000000001
100000000000000000000000000001
100000000000000000004000000001
100000040000000000000000000001
100000000000000000004000000001
100000040000050000000000000001
100000000000000000004000000001
100000040000000000000000000001
100000000404040404040000000001
100000000000000000000000000001
100000000000000000000000000001
100000000000000000000000000001
140404040404040404040000000001
100000000000000000000000000001
100000000000000000000000000001
100000000000000000000000000001
100000000000000000000000000001
100004040404040404040404040401
100000000000000000000000000001
100000000000000000000000000001
100000000000000000000000000001
100000000000000000000000000001
140404040404040404040400000001
100000000000000000000000000001
100000000000000000000000000001
100000000000000000000000000001
100000000000400000400000000001
100000000000000000000000000001
100000000000000000000000000001
103000000000000000000000000001
100000000000000000000000000001
100000000000000000000000000001
111111111111111111111111111111