111111111111111111111111111111
100000000000000004040404040401
100500000000000000000000000001
100000000000000000040404040401
111111110000000000000000000001
100000010000000000000404040401
100000010000000000000000000001
100000010000000000000004040401
100000011111111000000000000001
100000000040001000000000040401
100000000000001000000000000001
100000000000001000000000000401
100000000000001000000000000001
100000000000001000000000000001
100000000000001000000000000001
100000000000001000000000000001
100000000000001111111100000001
100001400000000000400100000001
100001000000000000000140000001
100001000000000000000100000001
100001000000000000000100000001
100001000000000000000100000001
100001111000000000000100000001
100000001000000000000100000401
100000001400000000000100000001
100000001000000000000100000001
100000001111100000000100000001
100000000040100000000100000001
100000000000140000000100000001
100000000000100000000100000001
100000000000100000000100000001
100000000000100000000104000001
100000000000100000000100000001
100000000000100000000100000001
100000000000100000000100000001
100000000040100000000100000001
100000000000140000000100000001
100000000000100000000100000001
100000000000100000000100000001
100000000000100000000000000001
100000000000100000000000000001
100000000000100000000000000001
140000000000100000000000000001
100000000000140000000000000001
140400000000100000000000000001
100000000000100000000000004001
140404000300140000000000000001
100000000000100000000000000001
111111111111111111111111111111