111111111111111111111111111111
100000000000004001000000000001
105000000000000001000000000001
100000000000000001000000000001
100000000000000001000000000001
111111111100000001000000000001
100000000000000001000000100001
100000000000000001000000100001
100000000000000001000000100001
100000011111111111000000100001
100000000000400000000000100401
140000000000000000000000100001
100000000000000000000000100001
100000000000000000000000100001
111111111111111110000000100001
100000000000000000000000100001
100004000000000004000000100001
100000000000000000000000100001
100000000000000000000000140001
100000000400000000000400100001
103000000000000000000000100001
100000000000000000000000100001
111111111111111111111111100001
140000000000000000000000000001
100000000000000000000000000001
100000000000000000000000000001
100001111111111111111111111111
100000000000000000000000040001
100000000000000000000000000001
100000000000000000000000000001
100000000000000000000000000001
111111111111111111111100000001
100000000000000000000100000401
100000000000000030000100000001
100000000000000000000100000001
100000000000000000000100000001
100000000000000000000100000001
100000000000000000000140000001
140000000000000000000100000001
100000000000000000000100000001
100000400000000000000100000001
100000000000000000000100000401
100000000000000000000100000001
100011111111111111111100000001
100000000000000000000000000001
100000000000000000000000000001
100000000004000000000000000001
100000000000000000000000000041
111111111111111111111111111111