111111111111111111111111111111
100000000000000000000000000001
103000000000000000000000000001
100000000000000000000000000001
100000000000000000000000000001
100000000000000000000000000001
140404040404040404000000000001
100000000000000000000000000001
100000000000000000000000000001
100000000000000000000000000001
100000000000000000000000000001
100000004040404040404040404001
100000000000000000000000000001
100000000000000000000000000001
100000000000000000000000000001
100000000000000000000000000001
140404040404040404040404000001
100000000000000000000000000001
100000000000000000000000000001
100000000000000000000000000001
100000000000000000000000000001
100000000000000000000000000001
100000040404040404040404040401
100000000000000000000000000001
100000000000000000000000000001
100000000000000000000000000001
100000000000000000000000000001
140404040404040404040404000001
100000000000000000000000000001
100000000000000000000000000001
100000000000000000000000000001
100000000000000000000000000001
100004040404040404040404040401
100000000000000000000000000001
100000000000000000000000000001
100000000000000000000000000001
100000000000000000000000000001
100000000000000000000000000001
140404040404040404040404000001
100000000000000000000000000001
100000000000000000000000000001
100000000000000000000000000001
100000000000000000000000000001
100000040404040404040404040401
100000000000000000000000000001
100000000000000000000000005001
100000000000000000000000000001
100000000000000000000000000001
111111111111111111111111111111