111111111111111111111111111111
100000000000000000000000000001
105000000000000000000000000001
100000000000000000000000000001
100000000000000000000000000001
111111111111000000000111111111
100000000000000000000000000001
100000000000000000000000000001
100000000000000000000000000001
100000000000000000000000000001
100000011111111111111110000001
100000000000000000000000000001
100000000000000000000000000001
100000000000000000000000000001
100000000000000000000000000001
111111111111111100000000011111
100000000000000000000000000001
100000000000000000000000000001
100000000000000000000000000001
100000000000000000000000000001
100000000001111111111111111111
100000000000000000000000000001
100000000000000000000000000001
100000000000000000000000000001
111111111111100000011111111111
100000000000000000000000000001
100000000000000000000000000001
100000000000000000000000000001
100000000000000000000000000001
100000011111111111111111111111
100000000000000000000000000001
100000000000000000000000000001
100000000000000000000000000001
100000000000000000000000000001
100000000000000000000000000001
111111111111111100000011111111
100000000000000000000000000001
100000000000000000000000000001
100000000000000000000000000001
100000000000000000000000000001
100000111111111111111110000001
100000000000000000000000000001
100000000000000000000000000001
100000000000000000000000000001
100000000000111111111111111111
100000000000000000000000000001
103000000000000000000000000001
100000000000000000000000000001
111111111111111111111111111111