111111111111111111111111111111
100000000000005000000000000001
100000000000000000000000000001
100000000000000000000000000001
100001111111111111111111100001
100000000000000000000000000001
100000000000000000000000000001
100000000000000000000000000001
100001111111111111111111100001
100000000000000000000000000001
100000000000000000000000000001
100000000000000000000000000001
100111111111000000111111111001
100000000000000000000000000001
100000000000000000000000000001
100111111111000000111111111001
100000000000000000000000000001
100000000000000000000000000001
100000000000000000000000000001
100111111111000000111111111001
100000000000000000000000000001
100000000000000000000000000001
100000000000000000000000000001
100001111111111111111111100001
100000000000000000000000000001
100000000000000000000000000001
100000000000000000000000000001
100001111111111111111111100001
100000000000000000000000000001
100000000000000000000000000001
100000000000000000000000000001
100111111111000000111111111001
100000000000000000000000000001
100000000000000000000000000001
100000000000000000000000000001
100111111111000000111111111001
100000000000000000000000000001
100000000000000000000000000001
100000000000000000000000000001
100004040404040404040404000001
100000000000000000000000000001
100000000000000000000000000001
100000000000000000000000000001
100000000000000000000000000001
100000000000003000000000000001
100004000000000000000004000001
100000000000000000000000000001
100000000000000000000000000001
111111111111111111111111111111