111111111111111111111111111111
100000000000000000000000000001
100500000000000000000000000001
100000000000000000000000000001
100000000000000000000000000001
100000000000000000000000000001
100040000040000040000040000001
100000000000000000000000000001
100000000000000000000000000001
100000000000000000000000000001
100000000000000000000000000001
100040000040000040000040000001
100000000000000000000000000001
100000000000000000000000000001
100000000000000000000000000001
100000000000000000000000000001
100040000040000040000040000001
100000000000000000000000000001
100000000000000000000000000001
100000000000000000000000000001
100040000040000040000040000001
100000000000000000000000000001
100000000000000000000000000001
100000000000000000000000000001
100000000000000000000000000001
100040000040000040000040000001
100000000000000000000000000001
100000000000000000000000000001
100000000000000000000000000001
100040000040000040000040000001
100000000000000000000000000001
100000000000000000000000000001
100000000000000000000000000001
100040000040000040000040000001
100000000000000000000000000001
100000000000000000000000000001
100000000000000000000000000001
100040000040000040000040000001
100000000000000000000000000001
100000000000300000000000000001
100000000000000000000000000001
100040000040000040000040000001
100000000000000000000000000001
100000000000000000000000000001
100000000000000000000000000001
100040000040000040000040000001
100000000000000000000000000001
100000000000000000000000000001
111111111111111111111111111111