111111111111111111111111111111
100000000000000000000000004001
100500000000000000000000000001
100000000000000000000000000001
100000000000000000000000000001
111111111111111111111100000001
100000000000000000000000000001
100000000000000000000000000001
140000000000000000000000040001
100000000000000000000000000001
100000011111111111111111111111
100000000000000000000000004001
100000000000000000000000000001
100000000000000000000000000001
140000000000000000000000000001
100000000000000000000000000001
111111111111111111111110000001
140000000000000000000000000001
100000000000000000000000000001
100000000000000000000000000001
100000001111111111111111111111
100000000000000000400000004001
100000000000000000000000000001
140000000000000000000000000001
100000000000000000000000000001
100000000004000000000000000001
100000000000000000000000000001
111111111111111111111100000001
100000000000000000004000004001
100000000000000000000000000001
100000000000000000004000000001
100004004004004000000000000001
100000000000000000004000000001
100004000000000000000000000001
100000000000000000004000000001
100004000000000000000000000001
100000000000000000004000004001
100004000000000000000000000001
100000000000000000004000000001
100004000000000000000000000001
100000030030030000004000000001
100004000000000000000000004001
100000000000000000004000000001
100000404040404040400000000001
100000000000000000004000000001
100000000000000000000000000001
100000000000000000000000000001
100000000000000000000000000001
111111111111111111111111111111