111111111111111111111111111111
100040000000000000000000004001
100000000000000000000000000001
100000000004000000000000000001
100000000000000000000000000001
100000011111111111111100000001
140000014000000000000100000001
100000010000000000000100000001
100000010000000000000100000001
100000010000000000000100000001
100000010000000000300100000401
100000010000000000000100000001
100400014000000111111100000001
100000010000000000000000000401
100000010000000000000000000001
100000010400000000000000000001
100000010000000000000000000401
100004010000040000000000000001
100000010000000000400000000001
100000010000000000000004000001
100000010000000000000000000001
100000011111111111111111111111
100000004000000000000000004001
100000000000000000000000000001
100000000000000000000000000001
100000000000000000000000000001
140000000000000000000000000001
100000000000040000000000000001
100000000000000000000000000001
100000000000000000000000000001
111111111111111110000000000001
100000000000000000000000000001
140000000000000000000000000001
100000004000000000000000004001
100000000000000000000000000001
100000111111111111111111111111
100000000000000040000000000001
100000000000000000000000000001
100000000000000000000000000001
100000000040000000000000000001
104000000000000000000400000001
100000000000000000000000000001
111111111111111111111111100001
100000000000000000000000000001
100000000000000000000000000001
105000000000000000000000000001
100000000000000000000000000001
100000000000000000000000000001
111111111111111111111111111111