111111111111111111111111111111
100000000000000000000000000001
105000000000000000000000000001
100000000000000000000000000001
111100001110000011100001110001
100000000000000000000000000001
100000000000000000000004000001
100000000000000000000000000001
111110111110011111101111110001
100000000000000000000000000001
100000000000000000000000000001
100000000000000000000000000001
100000000000000000000000000001
100011110000111111101111111111
100000000000000000000000000001
100000000000000000000000000001
100000000000000000000000000001
111111111111111101111110000001
100000000000000000000000000001
100000000000000000000000000001
100000000000000000000000000001
100000000000000000000000000001
111111000001111111111111111111
100400000000004000040000040001
100000000000000040000000000001
100400000000000000000000000001
100000000000000000000000000001
100000000000000000000000000001
111111111111111111111111000001
100000000000000000000000000001
100000000000000000000000000001
100000000000000000000000000001
100000000000000000000000000001
100001111000011111111111111111
140000000000000000000000004001
100000000000000000000000000001
100000000000040000000000000001
100000000000000000000000000001
111111111111111111111110000001
100000004000000000000000000001
100000000000000000000000000401
100000000000000000000000000001
100000000000000000000000000001
100000111111111111111111111111
100000000000000000000000000001
100000000000000000000000030001
100000040000000000000000000001
100000000000000000000000000001
111111111111111111111111111111