111111111111111111111111111111
100000000000500000000000000001
104000000000000000000000004001
100000000000000000000000000001
100000000000000000000000000001
100000000000000000000000000001
100004011111111111111140000001
100000000000000000000000000001
100000000000000000000000000001
100000000000000000000000000001
100000000000000000000000000001
111111111100000000011111111111
100000000000000000000000000001
100000000000000000000000000001
100000000000000000000000000001
100000000000000000000000000001
100000000000000000000000000001
100004011111111111111140000001
100000000000000000000000000001
100000000000000000000000000001
100000000000000000000000000001
100000000000000000000000000001
111111111100000000011111111111
100000000000000000000000000001
100000000000000000000000000001
100000000000000000000000000001
100000000000000000000000000001
100000000000000000000000000001
100000000000000000000000000001
100004011111111111111140000001
100000000000000000000000000001
100000000000000000000000000001
100000000000000000000000000001
100000000000000000000000000001
100000000000000000000000000001
111111111100000000011111111111
100000000000000000000000000001
100000000000000000000000000001
100000000000000000000000000001
100000000000000000000000000001
100000000000000000000000000001
100004011111111111111140000001
100000000000000000000000000001
100000000000000000000000000001
100000000000000000000000000001
103000000000040404000000003001
100000000000000000000000000001
100000000000000000000000000001
111111111111111111111111111111