111111111111111111111111111111
100000004004004000400400400001
100500000000000000000000000401
100000000000000000000000000001
100000000000000000000000000001
100000000000000000000000000001
140000000000000000000000000401
100000000000000000000000000001
100000000000000000000000000001
100000000000000000000000000401
100000000000000000000000000001
100000000000000000000000000001
100000000000000000000000000001
100000000000000000000000000401
100000000000000000000000000001
100000000000000000000000000001
100000000000000000000000000401
104004004004004000000000000001
100000000000000000000110000001
104004004004004000000110000401
100000000000000000000000000001
104004004004004000000000000001
100000000000000000000000000001
100000000000000000000000000401
100000000000000000000000000001
100000000000000000000000000001
100000000000000000000000000001
100000000000000000000000000401
100000000000000000000000000001
100000000000000000000000000001
100000000000000000000000000401
100000000000000000000000000001
100000000000000000000000000001
100000000000000000000000000401
100000000000000000000000000001
100000000000000000000000000001
100000000000000000000000000401
100000000000000000000000000001
100000000000000000000000000001
100000000000000000000000000401
100000000000000000000000000001
100000000000000000000000000001
100000000400400400400400400401
100000000000000000000000000001
100000000000000000000000000001
100000000000000000000000030001
100000000000000000000000000001
100000000000000000000000000001
111111111111111111111111111111