111111111111111111111111111111
100000000000000004000000000001
105000000000000000000000000001
100000000000000000000000000001
100000000400000000000000000001
100000000000000000000000000001
111111111111111111111111000001
100000000000000000000000000001
100000000000000000000000000401
100000040000000000000000000001
100000000111111111111111111111
100000000100000000000000000401
100000000100000000000000000001
140000000140000000000000000001
100000000100000000001400000001
100000000100000000001000000001
100000000100000000401000000401
100000000100000000001000000001
140000000100000000001000000001
100000000140000000001000000001
100000000100000000001000000001
100000000000000000001000000401
140000000000000000401000000001
100000000000000000001000000001
105000000000000000001000000001
111111111111111111111000000001
140000000000000000000000000001
100000000000000000000000000401
100000000000000000000000000001
100000111111111111111111111111
100000000000000000000000000401
140000000000000000000000000001
100000000000000000000000000001
105000000000000000000000000001
111111111111111111111000000001
140000000000000000401000000001
100000000000000000001000000001
100000000000000000001000000001
140000040100000000401000000001
100000000140000000001000000001
100000000100000000001000000001
140000040100000000401000000001
100000000140000000001000000001
100000000100000000001000000001
100000000100000000001000000001
100000000100000000000000000001
100030000140000000000000000301
100000000100000000000000000001
111111111111111111111111111111