111111111111111111111111111111
100000000000000000000000000001
105000000000000000000000000001
100000000000000000000000000001
100000000000004000000000000001
100000000000000000000000004001
100000000000400000000000000001
100000000000000000000000000001
100000000040000000000000400001
100000000000000000000000000001
100000004000000000000040000001
100000000000000000000000000001
100000400000000000004000000001
100000000000000000000000000001
100040000000000000400000000001
100000000000000000000000000001
104000000000000040000000000001
100000000000000000000000000001
100000000000004000000000000401
100000000000000000000000000001
100000000000400000000000000001
100000000000000000000000000001
100000000040000000000000000001
100000000000000000000000000001
100000004000000000000000000001
100000000000000000000000000001
100000000000000000000000000001
100000000000000000000040000001
100000000000000000000000000001
100000000000000000004000000001
100000000000000000000000000001
100000000000000000400000000001
100000000000000000000000000001
100000000000000040000000000001
100000000000000000000000000001
100000000000004000000000000001
100000000000000000000000000001
100000000000400000000000000001
100000000000000000000000000001
100000000040000000000000000001
100000000000000000000000000001
100000004000000000000000000001
100000000000000000000000000001
100000400000000000000000000001
100000000000000000000000000001
100040000000000000000000000301
100000000000000000000000000001
100000000000000000000000000001
111111111111111111111111111111