111111111111111111111111111111
100000000000000000000000000001
105000000400000000040000040001
100000000000000000000000000001
100000000000000000000000000001
100000000000000000000000000001
100000000000000000000000000001
100000000000000000000000000001
100040000000040000000400000001
100000000000000000000000000001
100000000000000000000000000001
100000000000000000000000000001
100000004000000004000000040001
100000000000000000000000000001
100000000000000000000000000001
100000000000000000000000000001
100000000000000000000000000001
100040000000040000004000000001
100000000000000000000000000001
100000000000000000000000000001
100000000000000000000000000001
100000040000000004000000400001
100000000000000000000000000001
100000000000000000000000000001
100000000000000000000000000001
104000000000400000040000000001
100000000000000000000000000001
100000000000000000000000000001
100000000000000000000000000001
100000000000000000000000000001
100000400000000040000000040001
100000000000000000000000000001
100000000000000000000000000001
100000000000000000000000000001
100400000004000000004000000001
100000000000000000000000000001
100000000000000000000000000001
100000000000000000000000000001
100000040000000040000000400001
100000000000000000000000000001
100000000000000000000000000001
100000000000000000000000000001
100400000000400000004000000001
100000000000000000000000000001
100000000000000000000000000001
100000000000000000000000000001
100003000000400000000030000001
100000000000000000000000000001
111111111111111111111111111111