111111111111111111111111111111
100000010000000000000100000001
105000010000000000000100000301
100000010000000000000100000001
100000010000001000000100000001
100000010000001000000100000001
100000010000001000000100000001
100000010000001000000100000001
100000010000001000000100000001
100000010000001000000100000001
100000010000001000000100000001
100000010000001000000100000001
100000010000001000000100000001
100000010000001000000100000001
100000010000001000000100000001
100000010000001000000100000001
100000010000001000000100000001
100000010000001000000100000001
100000010000001000000100000001
100000010000001000000100000001
100000010000001000000100000001
100000010000001000000100000001
100000010000001000000100000001
100000010000001000000100000001
100000010000001000000100000001
100000010000001000000100000001
100000010000001000000100000001
100000010000001000000100000001
100000010000001000000100000001
100000010000001000000100000001
100000010000001000000100000001
100000010000001000000100000001
100000010000001000000100000001
100000010000001000000100000001
100000010000001000000100000001
100000010000001000000100000001
100000010000001000000100000001
100000010000001000000000000001
100000010000001000000000000001
100000010000001000000000000001
100000010000001000000000000001
100000010000001000000000000001
100000010000001000000000000001
100000000000001000000000000001
100000000000001000000000000001
100000000000001000000000000001
100000000000001000000000000001
100000000000001000000000000001
111111111111111111111111111111