111111111111111111111111111111
100000000000000000000000000001
105000000000000000000000000001
100000000040000000400000000001
100000000000000000000000000001
111111111110000000011111111111
103000030014000000010300003001
100000000010000000010000000001
100000000010000000010000000001
100000000010000004014000000401
100000000010000000010000000001
100000000010000000010000000001
140000004014000000010000000001
100000000010000000010000000001
100000000010000004014000000401
100000000010000000010000000001
140000004014000000010000000001
100000000010000000010000000001
100000000010000004014000000401
100000000010000000010000000001
140000004014000000010000000001
100000000010000000010000000001
100000000010000004014000000401
100000000010000000010000000001
140000004014000000010000000001
100000000010000000010000000001
100000000010000004014000000401
100000000010000000010000000001
140000004014000000010000000001
100000000010000000010000000001
100000000010000004014000000401
100000000010000000010000000001
140000004014000000010000000001
100000000010000000010000000001
100000000010000004014000000401
100000000010000000010000000001
140000004014000000010000000001
100000000010000000010000000001
100000000010000004014000000401
100000000010000000010000000001
100000000010000000010000000001
140000004014000000010000000001
100000000010000000010000000001
100000000010000000010000000001
100000000000000000000000000001
100000000000000000000000000001
100000000000004000000000000301
100000000000000000000000000001
111111111111111111111111111111